################
#......#.......#
#..P.B.#...T...#
#......#.......#
#..............#
################
