########
#P.BT..#
#P..T..#
#......#
########
