################
#......#.......#
#..P...#...T...#
#......#.......#
#..............#
################
